9
5
---J---J-
-JS------
--J------
----J--J-
---G-----
