9
7
--S-G----
-JJJJJJJ-
-JJJJJJJ-
-JJJJJJJ-
-JJJJJJJ-
-JJJJJJJ-
---------
